5 5
*****
*G*S*
* * *
*   *
*****